#############
#xx.x.x.x.xx#
###a#b#c#d###
  #a#b#c#d#
  #########
